{
  "mapDim": 10,
  "playerStart": { "x": 1, "y": 1 },
  "grid": [
    [1, 1, 1, 1, 1, 1, 1, 1, 1, 1],
    [1, 0, 0, 0, 0, 0, 0, 0, 0, 1],
    [1, 0, 1, 1, 1, 0, 1, 1, 0, 1],
    [1, 0, 0, 0, 1, 0, 1, 2, 0, 1],
    [1, 1, 1, 0, 1, 0, 1, 1, 0, 1],
    [1, 0, 0, 0, 0, 0, 0, 0, 0, 1],
    [1, 0, 2, 0, 1, 1, 1, 1, 0, 1],
    [1, 0, 1, 0, 0, 0, 0, 1, 3, 1],
    [1, 0, 0, 0, 1, 1, 0, 0, 0, 1],
    [1, 1, 1, 1, 1, 1, 1, 1, 1, 1]
  ],
  "enemies": [
    { "x": 5, "y": 1, "type": "GUARD" },
    { "x": 8, "y": 5, "type": "ARCHER" },
    { "x": 2, "y": 8, "type": "GUARD" }
  ],
  "items": [
    { "x": 4, "y": 3, "type": "COIN" },
    { "x": 7, "y": 8, "type": "COIN" }
  ]
}
