{
  "name": "Training Grounds",
  "mapDim": 15,
  "grid": [
    [1,1,1,1,1,1,1,1,1,1,1,1,1,1,1],
    [1,0,0,0,0,0,0,0,0,0,0,0,0,0,1],
    [1,0,0,0,0,0,1,0,0,0,0,0,0,0,1],
    [1,0,0,1,1,0,1,0,1,1,0,0,0,0,1],
    [1,0,0,1,0,0,1,0,0,1,0,0,0,0,1],
    [1,0,0,1,0,0,1,0,0,1,0,0,0,0,1],
    [1,0,0,0,0,0,0,0,0,0,0,1,1,0,1],
    [1,0,1,1,1,0,1,0,1,1,0,1,2,0,1],
    [1,0,0,0,0,0,1,0,0,0,0,1,1,0,1],
    [1,0,0,0,0,0,0,0,0,0,0,0,0,0,1],
    [1,0,0,0,0,0,0,0,0,0,0,0,0,0,1],
    [1,0,1,1,1,0,0,0,0,1,1,1,0,0,1],
    [1,0,0,0,0,0,0,0,0,0,0,0,0,0,1],
    [1,0,0,0,0,0,1,1,1,0,0,0,0,3,1],
    [1,1,1,1,1,1,1,1,1,1,1,1,1,1,1]
  ],
  "playerStart": {
    "x": 2,
    "y": 2
  },
  "enemies": [
    {"x": 8, "y": 5, "type": "NORMAL"},
    {"x": 12, "y": 7, "type": "ARCHER"},
    {"x": 5, "y": 12, "type": "SPEAR"}
  ],
  "items": [
    {"x": 4, "y": 3, "type": "coin", "value": 10},
    {"x": 7, "y": 8, "type": "coin", "value": 10},
    {"x": 11, "y": 13, "type": "health", "value": 3}
  ]
}